---------
---------
----++++-
----+--+-
----+--+-
----++++-
---------